111111111111111111111
120010000010000000001
101111101111101010101
100010100000101010101
101110101111111110111
100000000000000000001
101011101111101010111
101010101000101010001
101110101011111011101
100010000010101010001
111110111110101010101
100000001010001010101
111011101010111111101
101000101010001010101
101111101010111010101
101000101010001000001
101110101010101110101
100000000000101000101
101011111011111110101
101000001000000010101
101011101111111110101
101000100010001000101
111111111110111011111
100000000000101010001
101011111011101010111
101010100000100010001
101110101110111011101
100000101000000000101
101110111110111011101
100010001000100000001
111111111111111111131